111111111111111111111111
10001C000100001111111111
10101111P000100C11111111
101000CCC111101010000001
1000101000011E0100000001
111111111111111111111111