111111111111111
1P0001C00000001
101CC1011100101
1C100000E0001E1
111111111111111